You wake up on the deck of your ship. Your head is throbbing, slowly you begin to remember what happened. The storm, the waves, the reef. You are lucky you managed to survive. Your crew on the other hand, was not so fortunate. Marooned on an unknown island, you should try to find a way back home.

Tortuga
An Interactive Fiction by Jacob Sparks
Release 1 / Serial number 140219 / Inform 7 build 6G60 (I6/v6.32 lib 6/12N) SD

Scallywag
Me mighty ship, once the best in the world, now lay in pieces on this mysterious beach. As me glance west me can see the deep blue sea, and to me east I can see a beach. The beach that me seems to be marooned on. Maybe me should look belowdecks for some supplies

You can see a Tattered Flag here.

>x
What do you want to examine?

* * *

>d
Cargo Hold
Once stocked full of rum and food and everything me could imagine. Now me ship is almost bare save for some miscellaneous things.

You can see a Scraps of Wood and a Bottle of Rum (empty) here.

* * *

>down
Cargo Hold

* * *

>x me
As good-looking as ever.

* * *

>e
Beach

>w
Scallywag
Me mighty ship, once the best in the world, now lay in pieces on this mysterious beach. As me glance west me can see the deep blue sea, and to me east I can see a beach. The beach that me seems to be marooned on. Maybe me should look belowdecks for some supplies

* * *

>x flag
A flag that once struck fear into everyone who sailed the seas, now all crumpled torn, is barely respectable.

* * *

>w
You can't go that way.

>e
Beach