You wake up on the deck of your ship. Your head is throbbing, slowly you begin to remember what happened. The storm, the waves, the reef. You are lucky you managed to survive. Your crew on the other hand, was not so fortunate. Marooned on an unknown island, you should try to find a way back home.

Tortuga
An Interactive Fiction by Jacob Sparks Use no scoring
Release 1 / Serial number 140311 / Inform 7 build 6G60 (I6/v6.32 lib 6/12N) SD

Scallywag
Once a mighty ship, the best in the world, now lay in pieces on this mysterious beach. As you glance west you can see the deep blue sea, and to the east you can see a beach. The beach that you seem to be marooned on. Maybe you should look belowdecks for some supplies

You can see a Tattered Flag here.

>x
What do you want to examine?

>x me
As good-looking as ever.

* * *

>d
Cargo Hold
Once stocked full of rum and food and everything you could imagine. Now the ship is almost bare save for some miscellaneous things.

You can see a Scraps of Wood and a Bottle of Rum here.

>u
Scallywag
Once a mighty ship, the best in the world, now lay in pieces on this mysterious beach. As you glance west you can see the deep blue sea, and to the east you can see a beach. The beach that you seem to be marooned on. Maybe you should look belowdecks for some supplies

You can see a Tattered Flag here.

* * *

>down
Cargo Hold

>penis
That's not a verb I recognise.

* * *

>x me
As there are no mirros on this island you have no idea how you look. But knowing you, you probably look amazing.

* * *

>e
Beach
The beach is actually more of a cove. It bears a slight remblence to Makapuu the waves break. The main features of this beach seem to be the sand, the water and the large rocks randomly dotting the sand. Further East, you can see the treeline of what seems to be a massive jungle.

>w
Scallywag
Me mighty ship, once the best in the world, now lay in pieces on this mysterious beach. As me glance west me can see the deep blue sea, and to me east I can see a beach. The beach that me seems to be marooned on. Maybe me should look belowdecks for some supplies

>w
You can't go that way.

* * *

>e
Beach
The beach is actually more of a cove. It bears a slight remblence to Makapuu the waves break. The main features of this beach seem to be the sand, the water and the large rocks randomly dotting the sand. Further East, you can see the treeline of what seems to be a massive jungle.

>x sand
It's sand. It has a silky feel to it and it's a pale yellow color. As you look left you notice something partially covered by the sand. It looks like part of a shell..

>x shell
You can't see any such thing.

>take shell
You can't see any such thing.

>take conch
You can't see any such thing.

>take conch
You can't see any such thing.

* * *

>e
Beach
The beach is actually more of a cove. It bears a slight remblence to Makapuu the waves break. The main features of this beach seem to be the sand, the water and the large rocks randomly dotting the sand. Further East, you can see the treeline of what seems to be a massive jungle.

>e
It's a dark and spooky jungle. Maybe you should bring some light.

>e
It's a dark and spooky jungle. Maybe you should bring some light.

>e
It's a dark and spooky forest. Maybe you should bring some light.

>e
It's a dark and spooky forest. Maybe you should bring some light.

>ee
That's not a verb I recognise.

I beg your pardon?

>e
It's a dark and spooky forest. Maybe you should bring some light.

>x
What do you want to examine?

>x
What do you want to examine?

>w
You see nothing unexpected in that direction.

>w
Scallywag
Once a mighty ship, the best in the world, now lay in pieces on this mysterious beach. As you glance west me can see the deep blue sea, and to me east I can see a beach. The beach that me seems to be marooned on. Maybe me should look belowdecks for some supplies

You can see a Tattered Flag here.

>take flag
Taken.

>d
Cargo Hold
Once stocked full of rum and food and everything me could imagine. Now me ship is almost bare save for some miscellaneous things.

You can see a Scraps of Wood and a Bottle of Rum here.

>take wood
Taken.

>take rum
Taken.

>combine rum with flag
You now have a Flammable Cloth.

>combing cloth with wood
That's not a verb I recognise.

>combine scraps with cloth
You now have a Lit Torch.

>e
You can't go that way.

>u
Scallywag
Once a mighty ship, the best in the world, now lay in pieces on this mysterious beach. As you glance west me can see the deep blue sea, and to me east I can see a beach. The beach that me seems to be marooned on. Maybe me should look belowdecks for some supplies

>e
Beach

>e
Jungle

>e
You can't go that way.

* * *

>e
It's a dark and spooky jungle. Maybe you should bring some light.

>w
Scallywag
Once a mighty ship, the best in the world, now lay in pieces on this mysterious beach. As you glance west you can see the deep blue sea, and to the east you can see a beach. The beach that you seem to be marooned on. Maybe you should look belowdecks for some supplies

You can see a Tattered Flag here.

>w
Ocean

>d
Underwater Cave

>d
You can't go that way.

I beg your pardon?

* * *

>e
It's a dark and spooky jungle. Maybe you should bring some light.

>s
You can't go that way.

>e
It's a dark and spooky jungle. Maybe you should bring some light.

>x shell
You see nothing special about the Shell.

>take shell
You walk over towards the shell. As you get closer you notice that it's a lot larger then initially expected. You pull it out of the sand to get a closer look. It's a brilliant blue conch shell.

* * *

>s
You can't go that way.

>w
Scallywag
Once a mighty ship, the best in the world, now lay in pieces on this mysterious beach. As you glance west you can see the deep blue sea, and to the east you can see a beach. The beach that you seem to be marooned on. Maybe you should look belowdecks for some supplies

You can see a Tattered Flag here.

>x flag
A flag that once struck fear into everyone who sailed the seas, now all crumpled torn, is barely respectable. It looks like could become flammable if soaked in something...

* * *

>e
Beach
The beach is actually more of a cove. It bears a slight remblence to Makapuu the waves break. The main features of this beach seem to be the sand, the water and the large rocks randomly dotting the sand. Further East, you can see the treeline of what seems to be a massive jungle.

>x sanf
You can't see any such thing.

>x sand
It's sand. It has a silky feel to it and it's a pale yellow color. As you look left you notice something partially covered by the sand. It looks like part of a shell...

>x shell
It's a brilliant blue conch shell, the way it shimmers makes it seem almost magical.

>take shell
You walk over towards the shell. As you get closer you notice that it's a lot larger then initially expected. You pull it out of the sand to get a closer look. It's a brilliant blue conch shell. Sensing it may be valuable later you stash it away safely.

>i
You are carrying:
  a Magic Conch

* * *

>x flag
A flag that once struck fear into everyone who sailed the seas, now all crumpled torn, is barely respectable.

>d
Cargo Hold
Once stocked full of rum and food and everything me could imagine. Now me ship is almost bare save for some miscellaneous things.

You can see a Scraps of Wood here.

>x wood
Originally part of the hull of the Scallywag, these pieces of wood may come in handy later.

* * *

>x flag
A flag that once struck fear into everyone who sailed the seas, now all crumpled torn, is barely respectable.

>take flag
Taken.

>i
You are carrying:
  a Tattered Flag

* * *

>w
Ocean

>e
Beach

>e
You can't go that way.

>e
You can't go that way.

I beg your pardon?

>e
You can't go that way.

* * *

>w
Ocean

>w
You can't go that way.

* * *

>take flag
Taken.

>d
Cargo Hold
Once stocked full of rum and food and everything you could imagine. Now the ship is almost bare save for some miscellaneous things.

You can see a Scraps of Wood and a Bottle of Rum here.

>take rum
Taken.

* * *

>combine rum with flag
You now have a Flammable Cloth.

>combine cloth with wood
(first taking the Scraps of Wood)
You now have a Torch.

* * *

>d
Cargo Hold
Once stocked full of rum and food and everything you could imagine. Now the ship is almost bare save for some miscellaneous things.

You can see a Scraps of Wood and a Bottle of Rum here.

>take wood
Taken.

* * *

>combine rum with flag
You now have a Flammable Cloth.

>combine cloth with wood
You now have a Lit Torch.

>u
Scallywag
Once a mighty ship, the best in the world, now lay in pieces on this mysterious beach. As you glance west you can see the deep blue sea, and to the east you can see a beach. The beach that you seem to be marooned on. Maybe you should look belowdecks for some supplies

>e
Beach

>take shell
You walk over towards the shell. As you get closer you notice that it's a lot larger then initially expected. You pull it out of the sand to get a closer look. It's a brilliant blue conch shell.

>i
You are carrying:
  a Magic Conch
  a Lit Torch

>e
Jungle

>u
You can't go that way.

>e
You can't go that way.

>n
Volcano
You can see Calypso here.

>x calypso
A spooky looking witch lady, she looks startled as if she hasn't seen another person in forever. She is carrying a large weathered rucksack.  She is carrying a Fishbowl . Calypso looks angry.

>take fishbowl
That seems to belong to Calypso.

>ask calypso for fishbowl
Calypso glares at you angrily, "You should give me something first!" she says.

* * *

I beg your pardon?

>x calypso
A spooky looking witch lady, she looks startled as if she hasn't seen another person in forever. She is carrying a large weathered rucksack. . Calypso looks happy.

>i
You are carrying:
  a Fishbowl
  a Lit Torch

* * *

>take wood
Taken.

>combine rum with flag
(first taking the Bottle of Rum)
You now have a Flammable Cloth.

>combine cloth with wood
You now have a Lit Torch.

* * *

>u
Scallywag
Once a mighty ship, the best in the world, now lay in pieces on this mysterious beach. As you glance west you can see the deep blue sea, and to the east you can see a beach. The beach that you seem to be marooned on. Maybe you should look belowdecks for some supplies

>e
Beach
The beach is actually more of a cove. It bears a slight remblence to Makapuu the waves break. The main features of this beach seem to be the sand, the water and the large rocks randomly dotting the sand. Further East, you can see the treeline of what seems to be a massive jungle.

>take shell
You walk over towards the shell. As you get closer you notice that it's a lot larger then initially expected. You pull it out of the sand to get a closer look. It's a brilliant blue conch shell. Sensing it may be valuable later you stash it away safely.

>e
Jungle
A jungle, packed with tons of trees. A path seems to be laid out through the middle of it. As you follow along the path it come to a split. Going north seems to lead toward a volcano and going south seems to lead into an even darker section of forest.

You can see a vines here.

>n
Volcano
After a long hik to the top of the mountain you realize that it wasn't just any mountain. It's a live volcano. The crater is pretty sparce save for some lava and a crazy looking witch lady swimming through it.

You can see Calypso here.

>give calypso shell
"Oooh thanks! This is such a pretty conch. It'll fit nicely in my collection. Here take this Fishbowl."

>s
Jungle
A jungle, packed with tons of trees. A path seems to be laid out through the middle of it. As you follow along the path it come to a split. Going north seems to lead toward a volcano and going south seems to lead into an even darker section of forest.

You can see a vines here.

>w
Beach
The beach is actually more of a cove. It bears a slight remblence to Makapuu the waves break. The main features of this beach seem to be the sand, the water and the large rocks randomly dotting the sand. Further East, you can see the treeline of what seems to be a massive jungle.

>w
Scallywag
Once a mighty ship, the best in the world, now lay in pieces on this mysterious beach. As you glance west you can see the deep blue sea, and to the east you can see a beach. The beach that you seem to be marooned on. Maybe you should look belowdecks for some supplies

>w
Ocean
As you securely fasten the Fishbowl around your head as a makeshift scuba helmet you jump from the deck of The Scallywag into the ocean. The ocean is crystal clear with rays of sunlight dancing around on the bottom of the sea. You see a large bed of coral and schools of fish.

>d
Underwater Cave
You slide the piece of coral, widening the opening just enough for you to fit through. You swim through a small tunnel and pop up in a cave. The cave seems pretty large and is dimly lit by the eerie glow of large ghostly looking ship. On the ground next to the ship is a small little container.

A compass, seems to be oriented correctly. All you need is a ship and you should be able to get home in no time.

Could this be it? You've heard rumors of this ship. It's said to be the fastest ship in the universe and captained by the most feared pirate of all. Nobody has ever seen this ship and lived, but now it's all yours.

>take compass
Taken.

>get in Flying Dutchman
You get into the Flying Dutchman.

You board the Flying Dutchman and steer it down a tunnel an out onto the open ocean. Using the compass you navigate back to your home port. Life is good.

    *** You have won ***

In that game you scored 0 out of a possible 0, in 18 turns.

Would you like to RESTART, RESTORE a saved game, QUIT or UNDO the last command?

>undo
Underwater Cave
[Previous turn undone.]

>i
You are carrying:
  a Compass
  a Fishbowl
  a Lit Torch
  a Pirate Clothes

>drop compass
Dropped.

>get in Flying Dutchman
You get into the Flying Dutchman.

* * *

>d
Cargo Hold
Once stocked full of rum and food and everything you could imagine. Now the ship is almost bare save for some miscellaneous things.

You can see a Scraps of Wood and a Bottle of Rum here.

>take woof
You can't see any such thing.

>take wood
Taken.

>combine flag with rum
(first taking the Bottle of Rum)
You now have a Flammable Cloth.

>combine wood with clothg
You can't see any such thing.

>combine wood with cloth
You now have a Lit Torch.

>u
Scallywag
Once a mighty ship, the best in the world, now lay in pieces on this mysterious beach. As you glance west you can see the deep blue sea, and to the east you can see a beach. The beach that you seem to be marooned on. Maybe you should look belowdecks for some supplies

* * *

>e
Beach

>take shell
You walk over towards the shell. As you get closer you notice that it's a lot larger then initially expected. You pull it out of the sand to get a closer look. It's a brilliant blue conch shell. Sensing it may be valuable later you stash it away safely.

>e
Jungle

* * *

>u
You can't go that way.

>n
Volcano
You can see Calypso here.

>give shell to calypso
Oooh thanks! This is such a pretty conch. It'll fit nicely in my collection. Here take this Fishbowl.

>i
You are carrying:
  a Lit Torch

* * *

>d
Cargo Hold
Once stocked full of rum and food and everything you could imagine. Now the ship is almost bare save for some miscellaneous things.

You can see a Scraps of Wood and a Bottle of Rum here.

>combine rum and flag
You can't use multiple objects with that verb.

>combine rum with flag
(first taking the Bottle of Rum)
You now have a Flammable Cloth.

>combine cloth with wood
(first taking the Scraps of Wood)
You now have a Lit Torch.

>u
Scallywag
Once a mighty ship, the best in the world, now lay in pieces on this mysterious beach. As you glance west you can see the deep blue sea, and to the east you can see a beach. The beach that you seem to be marooned on. Maybe you should look belowdecks for some supplies

* * *

>e
You can't go that way.

>w
Beach

>e
Jungle

>n
Volcano
You can see Calypso here.

>x calypso
You see nothing special about Calypso.

* * *

>d
Cargo Hold
Once stocked full of rum and food and everything you could imagine. Now the ship is almost bare save for some miscellaneous things.

You can see a Scraps of Wood and a Bottle of Rum here.

>combine flag with rum
(first taking the Bottle of Rum)
You now have a Flammable Cloth.

>combine rum with cloth
You can't see any such thing.

>combine cloth with wood
(first taking the Scraps of Wood)
You now have a Lit Torch.

>e
You can't go that way.

>u
Scallywag
Once a mighty ship, the best in the world, now lay in pieces on this mysterious beach. As you glance west you can see the deep blue sea, and to the east you can see a beach. The beach that you seem to be marooned on. Maybe you should look belowdecks for some supplies

>w
It's a deep ocean, looks great to explore, if only you had some kind of make-shift scuba helmet.

>e
Beach
The beach is actually more of a cove. It bears a slight remblence to Makapuu the waves break. The main features of this beach seem to be the sand, the water and the large rocks randomly dotting the sand. Further East, you can see the treeline of what seems to be a massive jungle.

>e
Jungle
A jungle, packed with tons of trees. A path seems to be laid out through the middle of it. As you follow along the path it come to a split. Going north seems to lead toward a volcano and going south seems to lead into an even darker section of forest.

You can see a vines here.

>w
Beach
The beach is actually more of a cove. It bears a slight remblence to Makapuu the waves break. The main features of this beach seem to be the sand, the water and the large rocks randomly dotting the sand. Further East, you can see the treeline of what seems to be a massive jungle.

>take shell
You walk over towards the shell. As you get closer you notice that it's a lot larger then initially expected. You pull it out of the sand to get a closer look. It's a brilliant blue conch shell. Sensing it may be valuable later you stash it away safely.

* * *

>e
Jungle
A jungle, packed with tons of trees. A path seems to be laid out through the middle of it. As you follow along the path it come to a split. Going north seems to lead toward a volcano and going south seems to lead into an even darker section of forest.

You can see a vines here.

>e
You can't go that way.

>n
Volcano
After a long hik to the top of the mountain you realize that it wasn't just any mountain. It's a live volcano. The crater is pretty sparce save for some lava and a crazy looking witch lady swimming through it.

You can see Calypso here.

* * *

>give calypso shell
"Oooh thanks! This is such a pretty conch. It'll fit nicely in my collection. Here take this Fishbowl."

>i
You are carrying:
  a Fishbowl
  a Lit Torch

>s
Jungle
A jungle, packed with tons of trees. A path seems to be laid out through the middle of it. As you follow along the path it come to a split. Going north seems to lead toward a volcano and going south seems to lead into an even darker section of forest.

You can see a vines here.

* * *

>combine flag with rum
(first taking the Bottle of Rum)
You now have a Flammable Cloth.

>combine cloth with wood
(first taking the Scraps of Wood)
You now have a Lit Torch.

* * *

>e
Jungle
A jungle, packed with tons of trees. A path seems to be laid out through the middle of it. As you follow along the path it come to a split. Going north seems to lead toward a volcano and going south seems to lead into an even darker section of forest.

You can see a vines here.

>take vines
Taken.

>s
Ruins
As you begin walking through the pitch black darkness of the jungle you can faintly see a light all the way down at the end. As you emerge from the light you glance around at what appears to be some kind of ancient temple. There is some kind of drawing on one end of the room and a chest on the other side.

An old chest that looks extremly worn. It may have had a padlock at some time but now it's just sitting there.

* * *

>w
Ocean
As you securely fasten the Fishbowl around your head as a makeshift scuba helmet you jump from the deck of The Scallywag into the ocean. The ocean is crystal clear with rays of sunlight dancing around on the bottom of the sea. You see a large bed of coral and schools of fish.

>d
Underwater Cave
You slide the piece of coral, widening the opening just enough for you to fit through. You swim through a small tunnel and pop up in a cave. The cave seems pretty large and is dimly lit by the eerie glow of large ghostly looking ship. On the ground next to the ship is a small little container.

You can see a Compass and a Flying Dutchman (empty) here.

>take compass
Taken.

>enter Dutchman
You get into the Flying Dutchman.

You board the Flying Dutchman and steer it down a tunnel an out onto the open ocean. Using the compass you navigate back to your home port. Life is good.

    *** You have won ***

In that game you scored 0 out of a possible 0, in 17 turns.

Would you like to RESTART, RESTORE a saved game, QUIT or UNDO the last command?

* * *

>d
Cargo Hold
Once stocked full of rum and food and everything you could imagine. Now the ship is almost bare save for some miscellaneous things.

You can see a Scraps of Wood and a Bottle of Rum here.

>combine rum with flag
(first taking the Bottle of Rum)
You now have a Flammable Cloth.

* * *

>e
Jungle
A jungle, packed with tons of trees. A path seems to be laid out through the middle of it. As you follow along the path it come to a split. Going north seems to lead toward a volcano and going south seems to lead into an even darker section of forest.

You can see a vines here.

>s
Ruins
As you begin walking through the pitch black darkness of the jungle you can faintly see a light all the way down at the end. As you emerge from the light you glance around at what appears to be some kind of ancient temple. There is some kind of drawing on one end of the room and a chest on the other side.

You can see a chest (closed) here.

>open chest
For a small chest the lid is extremly heavy. As you finally manage to get it open you realize that it is empty. Save for a small piece of paper at the bottom.

>take paper
You can't see any such thing.

* * *

>i
You are carrying:
  a Pirate Clothes